111111111111111111111111111111
100000000000000000000000000001
10C00C0000000101000C0000000001
100000000000111110000000000001
100000000000011100000000000001
10P0000C00C0001000000C00E000C1
100000000000000000000000000001
111111111111111111111111111111
